NO ./images/wood.xpm
SO ./images/greystone.xpm
WE ./images/colorstone.xpm
EA ./images/mossy.xpm

C 231,236,249
F 74,41,41


  11 1   11111111111111111111
  10101 1001   10000000000001
  1000011011   10000000000001
  100110N0001  10000000000001
110111111011   11111111111111
10000000001      111000111
1111111111        111111
1111111111111111111111111111111
1111100000000000000000001111111
111110000000000000000011111
1111111100000000011111
111111111111111111